[
  [
    ["A", "A", "A", "A", "A", "A", "A", "A", "A", "A"],
    ["A", "A", "A", "A", "A", "A", "A", "A", "A", "A"],
    ["A", "A", "A", "A", "A", "A", "A", "A", "A", "A"],
    ["A", "B", "A", "A", "A", "A", "A", "A", "A", "A"],
    ["A", "A", "A", "G", "A", "A", "A", "A", "A", "A"],
    ["A", "A", "A", "C", "A", "C", "C", "A", "C", "A"],
    ["A", "A", "C", "K", "A", "K", "K", "A", "K", "C"],
    ["C", "C", "K", "K", "A", "K", "K", "A", "K", "K"]
  ],
  [
    ["A", "A", "A", "A", "A", "A", "A", "A", "A", "A"],
    ["A", "A", "A", "A", "A", "A", "A", "A", "A", "A"],
    ["A", "A", "A", "A", "A", "B", "B", "A", "A", "A"],
    ["A", "B", "A", "A", "A", "A", "A", "A", "A", "A"],
    ["A", "A", "A", "A", "A", "A", "A", "A", "A", "A"],
    ["A", "A", "A", "C", "C", "C", "C", "A", "C", "G"],
    ["A", "A", "C", "K", "K", "K", "K", "C", "K", "C"],
    ["C", "C", "K", "K", "K", "K", "K", "K", "K", "K"]
  ],
  [
    ["A", "A", "A", "A", "A", "A", "A", "A", "A", "A"],
    ["A", "A", "A", "A", "A", "A", "A", "A", "A", "A"],
    ["A", "A", "A", "A", "A", "A", "A", "A", "A", "A"],
    ["A", "A", "A", "A", "A", "A", "A", "A", "A", "A"],
    ["A", "A", "A", "A", "A", "A", "A", "A", "A", "A"],
    ["A", "A", "A", "A", "A", "A", "A", "A", "A", "A"],
    ["A", "A", "A", "A", "A", "A", "A", "A", "A", "A"],
    ["C", "C", "C", "A", "C", "A", "C", "C", "A", "C"]
  ],
  [
    ["A", "A", "A", "A", "A", "A", "A", "A", "A", "A"],
    ["A", "A", "A", "A", "B", "A", "A", "A", "A", "A"],
    ["A", "A", "A", "A", "A", "A", "A", "A", "A", "A"],
    ["A", "A", "A", "A", "A", "A", "A", "A", "A", "A"],
    ["A", "A", "A", "C", "A", "A", "A", "A", "A", "A"],
    ["A", "A", "C", "K", "A", "A", "A", "C", "A", "A"],
    ["A", "C", "K", "K", "A", "A", "C", "K", "C", "A"],
    ["C", "K", "K", "K", "C", "C", "K", "K", "K", "C"]
  ]
]
