0	0	0	0	0	0	0	0	0	0	0	0	0	0	0
2	1	2	0	0	0	0	0	0	0	0	0	0	0	0
3	3	3	0	0	0	0	3	3	3	3	0	0	0	0
3	0	3	0	0	0	3	0	2	0	2	3	0	0	0
3	3	3	0	0	3	0	0	3	0	3	0	3	0	0
3	0	3	0	3	2	0	0	3	0	3	0	2	0	0
3	0	3	2	0	3	0	0	3	0	3	0	3	0	2
3	3	3	3	4b	3	4b	0	3	4b	3	4b	3	4b	3
3	3	2	2	2	2	2	2	2	2	2	2	2	2	2
0	0	0	3	0	3	0	0	3	0	3	0	3	0	3
0	0	0	3	0	3	0	0	3	0	3	0	3	0	3
0	0	0	0	0	3	1	0	3	1	3	1	3	0	0
