0	0	0	0	3	3	0	0	0	0	0	0	0	0	0
0	0	0	3	0	0	3	0	0	0	0	0	0	0	0
0	3	3	3	0	4a	0	3	3	3	0	0	0	0	0
0	3	0	3	3	3	3	3	0	3	0	0	0	0	0
2	2	2	2	0	0	0	2	2	2	0	0	0	0	0
2	3	0	0	0	0	0	3	0	3	2	0	0	0	0
2	3	0	0	0	0	0	3	0	3	2	0	0	0	0
2	3	4a	0	0	0	0	3	4a	3	2	0	0	0	0
2	2	2	2	0	0	0	2	2	2	2	0	0	0	0
2	3	0	2	0	0	0	2	0	3	2	0	0	0	0
2	3	0	2	0	0	0	2	0	3	2	0	0	0	0
2	3	4a	2	0	4a	0	2	4a	3	2	0	0	0	0
