0	0	0	0	0	0	3	0	0	3	0	0	0	0	0
0	0	0	0	0	0	3	3	3	3	0	0	0	0	0
0	0	0	0	0	0	3	0	0	3	0	0	0	0	0
0	0	0	0	3	0	3	0	4a	3	0	3	0	0	0
0	0	0	0	3	3	3	3	3	3	3	3	0	0	0
0	0	0	0	0	3	3	0	3	0	3	3	0	0	0
0	0	0	0	0	3	3	4a	3	4a	3	3	0	0	0
0	0	0	0	3	3	3	3	3	3	3	3	3	0	0
0	0	0	0	3	0	0	0	3	0	0	0	3	0	0
0	0	0	0	2	0	0	0	2	0	0	0	2	0	0
0	0	0	2	0	2	0	2	0	2	0	2	0	2	0
0	0	0	2	0	2	0	2	0	2	0	2	0	2	0
