0	0	0	0	1	2	0	0	0	0	0	0	0	0	0
0	0	0	0	0	0	0	2	0	0	0	0	0	0	0
0	0	3	2	0	0	0	0	0	0	0	0	0	0	0
1	0	3	3	4b	0	0	0	0	0	0	0	0	0	0
3	0	0	0	0	0	0	0	0	0	0	0	2	1	0
2	3	0	0	0	0	0	0	0	0	0	0	0	0	0
2	3	0	0	0	0	0	0	0	0	0	0	0	0	0
2	3	0	0	0	0	1	2	0	2	0	0	2	0	0
2	3	0	0	0	0	0	0	0	0	0	0	0	0	0
3	3	0	0	0	0	0	0	0	0	0	0	0	0	0
0	0	0	0	0	0	0	0	4a	4a	4a	0	0	0	0
0	0	2	0	4a	4a	4a	0	0	0	0	0	0	0	0
