0	0	0	0	0	0	0	1	0	0	1	0	0	0	0
0	0	0	0	0	0	0	1	0	0	1	0	1	0	1
0	0	1	0	1	0	0	1	0	0	1	0	1	1	1
0	0	1	1	1	1	0	1	3	3	1	0	3	0	1
0	0	1	0	0	3	0	1	1	1	1	0	3	0	1
0	0	1	2	2	3	0	1	0	0	1	0	3	0	1
0	0	3	3	3	3	0	1	0	4a	1	0	3	2	1
0	1	3	3	3	3	0	1	3	3	1	0	3	3	3
0	1	0	1	0	3	0	3	0	0	3	0	3	0	1
1	1	0	1	0	3	0	3	0	0	3	0	3	0	1
1	1	0	1	0	3	0	3	0	0	3	0	3	0	1
1	1	0	1	4a	3	0	3	4b	0	3	0	3	4a	1
