0	2	0	4a	0	2	0	0	0	0	0	0	0	0	0
0	3	3	3	3	3	0	0	0	0	0	0	0	0	0
0	1	1	1	1	1	0	0	0	0	0	0	4a	0	0
0	3	3	3	3	3	0	0	0	0	0	4a	4a	4a	0
0	0	3	1	3	0	0	0	0	0	0	2	4a	2	0
0	3	3	1	3	3	0	0	0	0	0	3	3	3	0
0	3	3	1	3	3	0	0	0	0	0	3	0	3	0
0	1	1	1	1	1	0	0	0	0	0	3	0	3	0
0	2	3	3	2	2	0	0	0	0	0	1	0	1	0
0	3	3	3	3	3	0	4a	4a	0	0	1	0	1	0
0	0	0	0	0	0	0	0	0	0	0	1	1	1	0
0	0	0	0	0	0	0	0	0	0	0	3	3	3	0
