0	0	0	0	0	0	0	0	0	0	0	0	0	2	0
0	0	0	0	0	0	0	0	0	0	0	2	2	2	0
0	0	0	0	0	0	0	0	0	0	0	0	0	2	2
0	0	0	0	0	0	0	0	0	0	0	0	0	3	0
0	0	0	0	0	0	0	0	0	0	0	0	0	3	0
0	0	0	0	0	0	0	0	0	0	0	0	0	3	0
0	0	0	0	0	0	0	0	0	0	0	2	4b	3	4b
0	0	0	0	0	0	0	0	0	0	0	2	2	2	2
3	0	0	0	0	3	0	0	0	0	0	0	2	2	2
0	3	0	0	0	0	3	0	0	0	0	0	2	2	2
0	0	3	0	4b	0	0	3	0	0	0	0	2	2	2
0	3	0	3	0	0	3	0	3	0	4b	0	2	2	3
