0	0	0	0	0	0	0	0	0	0	0	0	0	0	0
2	0	0	2	0	0	4c	0	0	0	0	2	0	0	2
2	0	0	2	0	0	1	1	0	0	0	2	0	0	2
2	2	2	2	0	1	0	0	1	0	0	2	2	2	2
0	2	2	0	1	0	0	0	0	1	0	2	0	0	2
0	2	2	0	0	0	0	0	1	0	0	2	2	2	2
0	2	2	0	4a	0	0	1	0	0	4a	2	2	2	2
0	2	2	2	2	2	2	2	2	2	2	2	2	2	2
0	0	0	0	0	2	0	0	2	0	0	0	0	0	0
0	0	0	0	0	2	0	0	2	0	0	0	0	0	0
0	0	0	0	0	2	0	0	2	0	0	0	0	0	0
0	0	0	0	0	2	4a	0	2	0	0	0	0	0	0
