0	0	0	0	0	0	1	1	1	0	1	0	0	0	0
0	0	0	0	0	0	1	1	1	1	1	0	0	0	0
0	0	0	0	1	0	1	1	0	1		0	0	0	0
0	0	0	1	0	0	1	1	0	1	1	0	0	0	0
0	0	0	0	0	0	3	3	0	3	3	0	0	0	0
0	0	0	0	0	0	2	3	4a	3	2	0	0	0	0
0	0	0	0	0	0	2	3	4b	3	2	0	0	0	0
0	0	0	1	1	1	1	1	0	1	1	1	1	1	0
0	0	0	2	2	2	2	3	2	3	2	0	2	0	0
0	0	2	2	2	0	2	3	4a	3	2	0	2	0	0
0	2	0	2	2	0	2	3	2	3	2	0	2	2	0
2	0	0	2	2	0	2	3	4a	3	2	0	2	0	2
