0	3	0	0	0	0	0	0	0	0	0	0	0	3	0
3	0	3	0	0	0	0	0	0	0	0	0	3	0	3
3	0	3	0	0	0	0	0	0	0	0	0	3	0	3
3	3	3	0	2	0	0	0	0	0	2	0	3	3	3
3	3	3	0	2	0	0	0	0	0	2	0	3	3	3
3	3	3	0	2	0	0	0	0	0	2	0	3	3	3
3	3	3	0	2	0	4a	0	4b	0	2	0	3	3	3
3	3	3	0	2	2	2	2	2	2	2	0	3	3	3
0	0	0	0	3	1	1	1	1	1	3	0	0	0	0
0	0	0	0	3	1	1	1	1	1	3	0	0	4a	0
0	0	0	0	3	3	3	3	3	3	3	0	0	3	3
0	0	0	3	0	0	0	3	0	3	0	3	4a	3	3
