0	0	0	3	3	3	3	3	0	0	0	0	0	0	0
0	0	0	0	3	0	3	0	3	3	3	3	3	0	2
0	0	0	0	3	0	3	0	0	3	0	3	0	1	1
0	0	0	0	3	0	3	0	0	3	4a	3	0	3	2
0	0	0	3	3	3	3	3	0	3	0	3	0	3	2
0	0	0	2	0	0	0	3	0	3	0	3	0	3	2
0	0	0	2	0	0	0	3	0	3	0	3	0	0	0
2	3	0	2	0	0	0	3	0	3	4a	3	0	0	0
2	2	0	3	3	3	3	3	0	3	3	3	0	0	0
2	2	0	3	0	0	0	3	0	0	0	0	0	0	0
2	2	0	3	0	0	0	3	0	0	0	0	0	0	0
2	2	0	3	0	4b	0	3	0	0	0	0	0	0	0
