0	0	0	0	0	0	0	0	0	0	0	0	0	0	0
0	0	0	0	0	0	0	0	0	0	0	0	4a	0	2
0	0	0	0	0	0	0	0	0	0	0	3	3	3	3
0	0	0	0	1	0	0	0	0	1	0	0	0	1	2
0	4a	0	0	1	0	0	0	1	0	0	0	0	3	2
0	1	1	0	1	0	0	0	0	4a	0	0	1	1	2
0	0	1	1	0	1	0	1	0	0	0	1	1	0	0
0	0	0	1	4a	0	1	4a	1	0	4a	1	0	0	0
0	0	0	0	1	1	1	1	1	1	1	0	0	0	0
0	0	0	0	0	0	0	0	0	1	0	0	0	0	0
0	0	0	0	0	0	1	4a	1	0	0	0	0	0	0
0	0	0	0	0	0	0	1	0	0	0	0	0	0	0
