0	0	0	0	0	0	0	0	0	0	0	3	0	3	0
0	3	3	3	0	0	0	0	0	0	0	3	1	3	0
0	3	1	3	0	0	3	3	3	0	0	3	1	3	0
0	3	1	3	0	0	3	1	3	0	0	3	1	3	0
0	3	1	3	0	0	3	1	3	0	0	3	1	3	0
3	3	3	3	2	0	3	1	3	0	3	3	3	3	2
3	3	3	3	2	0	3	1	3	0	3	3	3	3	2
2	2	2	3	2	0	3	1	3	0	2	2	2	3	2
2	0	2	3	2	0	3	1	3	0	2	0	2	3	2
2	0	2	3	2	0	3	1	3	0	2	0	2	3	2
2	0	2	3	2	0	3	3	3	0	2	4b	2	3	2
2	4a	2	3	2	0	0	2	0	0	0	0	0	0	0
