0	0	0	0	0	0	0	0	0	0	0	0	0	0	0
0	0	2a	0	0	0	0	0	0	0	0	2a	0	0	0
0	0	0	2	2	2	2	2	2	2	2	0	0	0	0
0	0	2a	0	0	0	0	0	0	0	0	2a	0	0	0
0	2	2	3	3	3	3	3	3	3	3	2	2	0	0
0	2	2	3	0	0	0	3b	0	0	3	2	2	0	0
0	2	2	3	0	0	4a	3	4a	0	3	2	2	0	0
0	2	2	2	2	2	2	2	2	2	2	2	2	0	0
2	2	2	2	2	2	2	0	0	2	2	2	2	2	2
0	2	2	2	2	0	0	0	0	2	2	2	2	0	0
0	2	2	2	2	0	0	0	0	2	2	2	2	0	0
0	2	2	2	2	0	0	4c	0	2	2	2	2	0	0
