0	0	0	0	0	0	0	0	0	0	0	0	0	0	0
0	0	0	0	0	0	0	0	0	0	0	0	0	0	0
0	0	0	2	0	0	0	0	0	0	0	0	0	0	0
0	0	0	2	0	0	0	0	0	2	0	0	0	0	0
0	0	0	2	0	0	0	0	0	2	0	0	0	0	0
0	0	0	2	0	0	0	0	0	2	0	0	0	0	0
0	0	2	2	2	0	0	0	2	2	2	0	0	0	0
0	0	2	0	2	0	0	0	2	0	2	0	0	0	0
0	0	2	0	2	0	0	0	2	0	2	0	0	0	0
0	0	2	0	2	0	0	0	2	4a	2	0	3	0	0
0	0	2	2	2	0	0	0	2	2	2	0	3	0	0
0	2	0	2	0	2	0	2	0	2	0	2	3	4a	4a
