0	0	0	0	1	1	1	1	1	1	1	0	0	0	0
0	0	0	0	1	0	0	1	0	0	1	0	0	0	0
0	0	0	0	1	0	0	1	0	0	1	0	0	0	0
0	0	0	1	1	1	1	1	1	1	1	1	1	0	0
0	0	0	1	0	0	1	0	0	1	0	0	1	0	0
0	0	0	1	0	0	1	0	0	1	0	0	1	0	0
0	0	0	1	0	0	1	0	4a	1	0	0	1	0	0
0	0	1	1	1	1	1	1	1	1	1	1	1	1	1
0	0	2	0	1	0	3	0	1	0	3	0	1	0	2
0	0	2	0	1	0	3	0	1	0	3	0	1	0	2
0	0	2	0	1	0	3	0	1	0	3	0	1	0	2
0	0	2	0	1	0	3	4b	1	4b	3	0	1	0	2
