0	0	0	0	0	0	0	3	0	0	0	0	0	0	0
0	0	0	0	0	0	3	3	3	0	0	0	0	0	0
0	0	0	0	0	0	3	0	3	0	0	0	0	0	0
0	0	0	0	0	0	3	0	3	0	0	0	0	0	0
0	0	0	0	0	0	3	4a	3	0	0	0	0	0	0
0	0	0	0	0	0	3	3	3	0	0	0	0	0	0
0	0	0	0	3	3	3	3	3	3	3	0	0	0	0
0	0	0	0	3	0	0	0	0	0	3	0	0	0	0
0	0	0	0	3	0	3	3	3	0	3	0	0	0	0
0	0	0	0	3	0	1	0	1	0	3	0	0	0	0
3	0	0	0	3	0	1	0	1	0	3	0	0	0	3
3	0	0	0	3	0	3	3	3	0	3	0	0	0	3
