0	0	0	0	0	0	0	0	0	0	0	0	0	0	0
0	0	0	3b	0	0	0	0	0	0	0	0	0	0	0
0	0	3b	1b	3b	0	0	0	0	0	0	0	0	0	0
3	3	3	3	3	3	3	0	0	0	0	0	0	0	0
3	0	0	3	0	0	3	0	0	0	0	0	0	0	0
3	0	0	3	4a	0	3	4a	0	0	0	0	0	0	0
3	3	3	3	3	3	3	3	0	0	0	0	0	0	0
3	0	3	2	0	0	0	2	0	0	0	0	0	0	3
3	3	3	2	0	0	0	2	0	0	0	0	0	0	3
3	0	3	2	0	4a	0	2	2b	0	0	0	0	4a	3
3	3	3	2	3	3	3	2	1b	2b	4a	0	3	0	3
3	0	3	2	3	0	3	2	2	2	2	0	3	0	3
